try=login.jsp
login=LoginServlet
logout=LogoutServlet
show=show.jsp
showRoom=ShowRoomServlet
showHotel=ShowHotelServlet
register=register.jsp
create=CreateNewAccountServlet
view=view.jsp
searchHotel=SearchHotelServlet
cart=CartServlet
showCart=cart.jsp
quantityCart=UpdateOrderServlet
delete=DeleteCartServlet
deleteBook=DeleteBookingServlet
confirm=ConfirmServlet
history=HistoryServlet
showHistory=history.jsp
searchDate=SearchDateServlet
reset=reset.jsp
send=ResetServlet
check=CheckCodeServlet
change=change.jsp
changePass=ChangePassServlet
discount=discount.jsp
createDiscount=CreateDiscountServlet
viewDetail=HistoryDetailServlet
detail=detail.jsp
rating=RatingServlet
code=UseCodeServlet